12,12
..........22
........2300
......022200
....24004242
..2022202020
202022042222
.22202022022
...222002050
.....0522220
.......03202
.........202
...........1
4
0,5,2,0
5,3,0,0
6,2,0,1
11,6,-1,0