15,15
......200......
....2024240....
..0022...2220..
2320.......2000
03....220....50
22..2032020..40
20..00...22..42
32..22.0.00..00
02..300.002..50
50...00200...40
020....2....022
.0200.....3202.
...5422.0020...
.....02250.....
.......0.......
5
0,3,1,1
0,6,1,1
4,1,0,1
7,0,0,0
9,1,0,1
0,0
editor