10,7
......0...
.....050..
......20..
000....320
250.0.02.0
..030..0..
...0......
0