10,7
....3.....
....020...
.....50.0.
.0....0523
.50...0042
025...020.
.000...0..
0
0,0
cell-tut2