13,12
...0422......
..2200520.0..
.040200.20205
.022200230220
032202240022.
222222222002.
.02.040005...
.22251.......
........20050
.......24.222
.......00502.
.........0...
0