27,17
..........2203424..........
........20022400042........
.......2022402200021.......
......245220523210522......
00012.012...222...201.20502
032422223...502...252022002
.0040202300.020.5000232202.
.0222301502350020204202222.
...1.0.2322224423052.3.2...
.........022...030.........
..........202.000..........
...........25020...........
...........32032...........
..........4032003..........
..........15...32..........
..........205.005..........
...........40230...........
0
0,0
suzanne