17,17
........2........
......22220......
......20220......
..2...20222...2..
21200..222..00222
20244...2...22004
02220...2...22220
.202.00.2.20.222.
.......402.......
..0...22002...0..
222202..0..240220
20240...0...02220
22040...0...30000
.222..22002..052.
......20022......
......25052......
.......203.......
7
0,4,1,0
1,4,1,0
8,0,0,1
10,1,0,0
13,4,0,0
16,4,0,1
16,4,-1,0
0,0
nutella