11,8
....000....
...02203...
0..22320..0
.00.....00.
...02.20...
....222....
..00...00..
00.......00
3
0,2,1,0
5,0,0,0
10,2,-1,0