13,11
..........000
..0........22
.020......230
.22.....2020.
.002200020...
...00202220..
..2030.0.222.
0320......02.
20.......302.
032..........
.2...........
8
0,7,0,1
1,4,3,1
3,4,0,1
5,4,0,1
7,4,0,1
10,5,0,1
12,0,0,1
12,1,-1,0