20,10
.................33.
....20022.........3.
..202022000.....000.
..22200222220..20330
...22222003223322320
....0330033003302022
..3023300330233220..
.33003320330033.....
...20330233223......
.....3300330........
0