19,11
................3..
....0.2..........3.
..0200220.......03.
.2220220202...20300
.222202202203.20330
...2320033023302022
..0033003300332202.
33023320330233.2...
.3203300332033.....
...033023302.......
.....3.0.3.........
0