17,14
...3.........0...
...2.........3...
...22.......00...
....0..300..2....
.0...0020232...3.
.22..300022...22.
...22023202200...
.....3302022.....
..0300300302322..
30...0003330...22
....233022000....
...0...012...2...
...3.........3...
..22.........20..
0