26,17
............0.....03......
..........01210...20......
........0.0322....030.....
......002023020...030.....
......0232322303201330....
.....023021012200222200...
....0122203223312303221...
..1023223222032220310320..
.132122212032021202012000.
.1202220020030223232221230
.0033232220303120222030220
.3303202320023202002231232
..022302222212123220320222
...121020100.002220312020.
...03222.......0.1002321..
...003...........2323200..
..................020203..
0