9,7
..03.....
.003.30..
323..023.
.20...003
.003..20.
...3.003.
.....3...
0
