9,7
..03.....
.003.30..
323..033.
.20...003
.003..30.
...3.003.
.....3...
0
