9,8
....3....
..10030..
203200320
30.....00
023...323
.........
..2...3..
.320.000.
0
0,0
no-guess