8,11
...30...
...2023.
...00..2
...30..0
...0022.
...3...2
...2...3
..02....
0020....
0323....
.0......
0