13,9
....30000....
...2000200...
...3030233...
300.03220.003
0003202033000
202022.320220
32220...02203
3002.....2203
.0.........2.
0
0,0
esc