16,9
202020002000202.
222200222020222.
202222220022202.
200022202220002.
222002222222000.
222222002220200.
202222200222202.
220002020000222.
...............3
0
0,0
game-name